#######################
#.........#...........#
#.###.###.#.###.###...#
#o#.....#...#.....#o..#
#.###.#.#####.#.###...#
#.....#...#...#.......#
#####.### # ###.#######
T.........P...........T
#####.### # ###.#######
#.....#...#...#.......#
#.###.#.#####.#.###...#
#o#.....#...#.....#o..#
#.###.###.#.###.###...#
#.........#...........#
#######################
